          ##############################
          #!---------------------------#
          #----------------------------#
          #-----------------############
          ########--#########           
                 #--#                   
                 #--####################
                 #---------------------#
                 #---------------------#
                 #---------------------#
                 ####################-##
###################################---##
###############################--------#
+--------------------------------------#
########################################
