          ##############################
          #!---------------------------#
          #----------------------------#
          #-----------------############
          ################--#           
                         #-#            
                         #-#            
                        #---#           
                        #---/           
                        #####           