########################################
#!-------------------------------------#
#--------------------------------------#
#--------------------------------------#
#######################-################
                      #-#               
          #############-################
          #----------------------------#
          #----------------------------#
          #-----------------############
          #######-###########           
##########------------------############
#--------------------------------------#
#--------------------------------------#
+-------------------------------------##
########################################